Lawrence	Laurie
Reed	Doris
Lawton	Lawrence
Outlaw	Marc
Ross	Marilyn
Gray	Judy
Griffin	Lillian
Bennett	Jane
Cary	Tim
Hale	Ramona
Black	Jean
Clark	James
Thomas	Rich
Young	Trevor
Alexander	Diana
Baker	Pamela
Burke	Lydia
Tirado	Lonnie
Hunt	Eleanor
Gilliland	Joe
Reid	Constance
Ramirez	Christina
Byrd	Deanna
Gunderson	Terrence
Bolin	Mathew
Vanhorn	Andy
Howland	Milton
Owens	Jean
Bollman	Owen
Becker	Owen
Corner	Kathy
